50
&
50
&
textures.png
&
00:1:0
#
01:1:1
#
02:1:2
#
03:1:3
#
04:1:4
#
05:1:5
#
06:1:6
#
07:1:7
#
08:1:8
#
09:1:9
#
10:1:10
#
11:1:11
#
12:1:12
#
13:1:13
#
14:1:14
#
15:1:15
&
05 05 06 03 03 03 03 03 03 03 03 03 03 03 03 03 03 03 03 03 03 03 03 03 03 03 03 03 03 03 03 03 03 03 03 03 03 03 03 03 03 03 03 03 03 03 03 03 03 03
05 05 06 03 03 03 03 03 03 03 03 03 03 03 03 03 03 03 03 03 03 03 03 03 03 03 03 03 03 03 03 03 03 03 03 03 03 03 03 03 03 03 03 03 03 03 03 03 03 03
05 05 15 01 01 01 01 01 01 01 01 01 01 01 01 01 01 01 01 01 01 01 01 01 01 01 01 01 01 01 01 01 01 01 01 01 01 01 01 01 01 01 01 01 01 01 04 03 03 03
05 05 05 05 05 05 05 05 05 05 05 05 05 05 05 05 05 05 05 05 05 05 05 05 05 05 05 05 05 05 05 05 05 05 05 05 05 05 05 05 05 05 05 05 05 05 06 03 03 03
05 05 10 07 07 07 07 07 07 07 07 07 13 05 10 07 07 13 05 10 07 07 07 07 07 07 07 07 07 07 07 07 07 07 07 07 07 07 07 07 07 07 07 13 05 05 06 03 03 03
05 05 06 03 03 03 03 03 03 03 03 03 08 05 06 03 03 08 05 06 03 03 03 03 03 03 03 03 03 03 03 03 03 03 03 03 03 03 03 03 03 03 03 08 05 05 06 03 03 03
05 05 06 03 03 03 03 03 03 03 03 03 08 05 06 03 03 08 05 06 03 03 03 03 03 03 03 03 03 03 03 03 03 03 02 02 02 02 02 02 02 03 03 08 05 05 06 03 03 03
05 05 06 03 03 03 03 03 03 03 03 03 08 05 06 03 03 08 05 06 03 03 03 03 03 03 03 03 03 03 03 03 03 03 02 05 05 05 05 05 02 03 03 08 05 05 06 03 03 03
05 05 15 01 01 02 02 02 02 02 02 03 08 05 06 03 02 02 05 02 02 03 03 03 03 12 01 01 01 01 01 01 01 01 02 05 05 05 05 05 02 03 03 11 07 07 09 03 03 03
05 05 05 05 05 05 05 05 05 05 02 03 08 05 06 03 02 05 05 05 02 03 03 03 03 08 05 05 05 05 05 05 05 05 05 05 05 05 05 05 02 03 03 03 03 03 03 03 03 03
05 05 05 05 05 05 05 05 05 05 02 03 08 05 06 03 02 02 02 02 02 03 03 03 03 08 05 10 07 07 07 07 07 07 02 05 05 05 05 05 02 03 03 03 03 03 03 03 03 03
07 07 07 07 07 02 05 05 05 05 02 03 08 05 06 03 03 03 03 03 03 03 03 03 03 08 05 06 03 03 03 03 03 03 02 05 05 05 05 05 02 03 03 03 03 03 03 03 03 03
03 03 03 03 03 02 05 05 05 05 02 03 08 05 06 03 03 03 03 03 03 03 03 03 03 08 05 06 03 03 03 03 03 03 02 02 02 02 02 02 02 03 03 03 03 03 03 03 03 03
03 03 03 03 03 02 02 02 02 02 02 03 08 05 06 03 03 03 03 03 03 03 03 03 03 08 05 06 03 03 03 03 03 03 03 03 03 03 03 03 03 03 03 03 03 03 03 03 03 03
03 03 03 03 03 03 03 03 03 03 03 03 08 05 06 03 03 03 03 03 03 03 03 03 03 08 05 06 03 03 03 03 03 03 03 03 03 03 03 03 03 03 03 03 03 03 03 03 03 03
03 03 03 03 03 03 03 03 03 03 03 03 08 05 06 03 03 03 03 03 03 03 03 03 03 08 05 06 03 03 03 03 03 03 03 03 03 03 03 03 03 03 03 03 03 03 03 03 03 03
03 03 03 12 01 01 01 01 01 01 01 01 14 05 15 01 01 01 01 01 01 01 01 01 01 14 05 15 01 01 01 01 01 01 01 01 01 01 01 01 01 01 01 01 01 04 03 03 03 03
03 03 03 08 05 05 05 05 05 05 05 05 05 05 05 05 05 05 05 05 05 05 05 05 05 05 05 05 05 05 05 05 05 05 05 05 05 05 05 05 05 05 05 05 05 06 03 03 03 03
03 03 03 08 05 05 05 05 05 05 05 05 10 07 07 07 07 13 05 10 07 07 07 07 07 07 07 07 07 07 07 07 07 07 07 07 07 07 07 07 07 07 07 07 07 09 03 03 03 03
03 03 03 08 05 05 05 05 05 05 05 05 06 03 03 03 03 08 05 06 03 03 03 03 03 03 03 03 03 03 03 03 03 03 03 03 03 03 03 03 03 03 03 03 03 03 03 03 03 03
03 03 03 08 05 05 05 05 05 05 05 05 06 03 03 03 03 08 05 06 03 03 03 02 02 02 02 02 02 02 02 02 02 02 02 02 02 02 02 02 02 02 02 02 02 02 02 02 03 03
03 03 03 08 05 05 05 05 05 05 05 05 06 03 03 03 03 08 05 06 03 03 03 02 05 05 05 05 05 05 05 05 05 05 05 05 05 05 05 05 05 05 05 05 05 05 05 02 03 03
03 03 03 08 05 05 05 05 05 05 05 05 06 03 03 03 03 08 05 06 03 03 03 02 05 05 02 02 02 02 02 05 05 05 02 02 02 02 02 02 02 02 02 02 02 05 05 02 03 03
03 03 03 08 05 05 05 05 05 05 05 05 06 03 03 03 03 08 05 06 03 03 03 02 05 05 02 02 02 02 02 05 05 05 02 03 03 03 03 03 03 03 03 03 02 05 05 02 03 03
03 03 03 08 05 05 05 05 05 05 05 05 06 03 03 03 03 08 05 06 03 03 03 02 05 05 05 05 05 05 05 05 05 05 02 03 02 02 02 02 03 03 03 03 02 05 05 02 03 03
03 03 03 08 05 05 05 05 05 05 05 05 06 03 03 03 03 08 05 06 03 03 03 02 02 02 02 02 02 02 02 05 02 02 02 03 02 00 00 02 03 03 03 03 02 05 05 02 03 03
03 03 03 08 05 05 05 05 05 05 05 05 06 03 03 03 03 08 05 06 03 03 03 03 03 03 03 03 03 03 08 05 06 03 03 03 02 00 00 02 03 03 03 03 02 05 05 02 03 03
03 03 03 08 05 05 05 05 05 05 05 05 06 03 03 03 03 08 05 06 03 03 03 03 03 03 03 03 03 03 08 05 06 03 03 03 02 00 00 02 03 03 03 03 02 05 05 02 03 03
03 03 03 08 05 05 05 05 05 05 05 05 06 03 03 03 03 08 05 06 03 03 03 03 03 03 03 03 03 03 08 05 06 03 03 03 02 00 00 02 03 03 03 03 02 05 05 02 03 03
03 03 03 08 05 05 05 05 05 05 05 05 06 03 03 03 03 08 05 06 03 03 03 03 03 03 03 03 03 03 08 05 06 03 03 03 02 00 00 02 02 02 02 02 02 05 05 02 03 03
03 03 03 11 07 07 07 07 07 07 07 07 09 03 03 03 03 08 05 06 03 03 03 03 03 03 03 03 03 03 08 05 06 03 03 03 02 00 00 05 05 05 05 05 05 05 05 02 03 03
03 03 03 03 03 03 03 03 03 03 03 03 03 03 03 03 03 08 05 06 03 03 03 03 03 03 03 03 03 03 08 05 06 03 03 03 02 02 02 02 02 02 02 02 02 02 02 02 03 03
03 03 03 03 03 03 03 03 03 03 03 03 03 03 03 03 03 08 05 06 03 03 03 03 03 03 03 03 03 03 08 05 06 03 03 03 03 03 03 03 03 03 03 03 03 03 03 03 03 03
03 12 01 01 01 01 01 01 01 01 01 01 01 01 01 01 01 14 05 15 01 01 01 01 01 01 01 01 01 01 14 05 15 01 01 01 01 01 01 01 01 01 01 01 01 01 01 01 04 03
03 08 05 05 05 05 05 05 05 05 05 05 05 05 05 05 05 05 05 05 05 05 05 05 05 05 05 05 05 05 05 05 05 05 05 05 05 05 05 05 05 05 05 05 05 05 05 05 06 03
03 08 05 10 07 07 07 13 05 10 07 07 07 07 07 07 07 07 07 07 07 07 07 07 07 07 07 07 07 07 07 07 13 05 10 07 07 07 07 07 07 07 07 07 07 07 07 07 09 03
03 08 05 06 03 03 03 08 05 06 03 03 03 03 03 03 03 03 03 03 03 03 03 03 03 03 03 03 03 03 03 03 08 05 06 03 03 03 03 03 03 03 03 03 03 03 03 03 03 03
03 08 05 06 03 03 03 08 05 06 03 03 03 03 12 01 01 01 01 01 01 01 01 01 01 01 01 01 01 01 01 01 14 05 06 03 03 03 03 03 03 03 03 03 03 03 03 03 03 03
03 08 05 06 03 03 03 08 05 06 03 03 03 03 08 05 05 05 05 05 05 05 05 05 05 05 05 05 05 05 05 05 05 05 06 03 03 03 03 03 03 03 03 03 03 03 03 03 03 03
03 08 05 06 03 03 03 08 05 06 03 03 03 03 08 05 05 02 02 02 02 02 02 02 02 02 02 02 02 02 02 02 02 02 02 03 03 03 03 03 03 03 03 03 03 03 03 03 03 03
03 08 05 06 03 03 03 08 05 06 03 03 03 03 08 05 05 05 05 05 05 05 05 05 05 05 05 05 05 05 05 05 05 05 02 03 03 03 03 03 03 03 03 03 03 03 03 03 03 03
03 08 05 06 03 03 03 08 05 06 03 03 03 03 08 05 05 05 05 05 05 05 05 05 05 05 05 05 05 05 05 05 05 05 02 03 03 03 03 03 03 03 03 03 03 03 03 03 03 03
03 08 05 06 03 03 03 08 05 06 03 03 03 03 11 07 07 07 07 07 07 07 07 07 07 07 07 07 07 07 07 07 13 05 06 03 03 03 03 03 03 03 03 03 03 03 03 03 03 03
03 08 05 06 03 03 03 08 05 06 03 03 03 03 03 03 03 03 03 03 03 03 03 03 03 03 03 03 03 03 03 03 08 05 06 03 03 03 03 03 03 03 03 03 03 03 03 03 03 03
03 08 05 06 03 03 03 08 05 06 03 03 03 03 03 03 03 03 03 03 03 03 03 03 03 03 03 03 03 03 03 03 08 05 06 03 03 03 03 03 03 03 03 03 03 03 02 02 02 02
03 08 05 06 03 03 03 08 05 15 01 01 01 01 01 01 01 01 01 01 01 02 01 01 02 03 03 03 03 03 03 03 08 05 15 01 01 01 01 01 01 01 01 01 01 01 02 05 05 02
03 08 05 06 03 03 03 08 05 05 05 05 05 05 05 05 05 05 05 05 05 05 05 05 02 03 03 03 03 03 03 03 08 05 05 05 05 05 05 05 05 05 05 05 05 05 05 05 05 02
03 08 05 06 03 03 03 11 07 07 07 07 07 07 07 07 07 07 07 07 07 02 07 07 02 03 03 03 03 03 03 03 11 07 07 07 07 07 07 07 07 07 07 07 07 07 02 05 05 02
03 11 07 09 03 03 03 03 03 03 03 03 03 03 03 03 03 03 03 03 03 03 03 03 03 03 03 03 03 03 03 03 03 03 03 03 03 03 03 03 03 03 03 03 03 03 02 02 02 02
03 03 03 03 03 03 03 03 03 03 03 03 03 03 03 03 03 03 03 03 03 03 03 03 03 03 03 03 03 03 03 03 03 03 03 03 03 03 03 03 03 03 03 03 03 03 03 03 03 03
&
00010000000000000000000000000000000000000000000000
00011111111111111111111111111111111111111111111100
00000000000000000000000000000000000000000000000100
00000000000000000000000000000000000000000000000100
00000000000000000000000000000000000000000000000100
00011111111100011000111111111111111111111110000100
00010000000100011000100000000000001111111010000100
00011100000100011000100011111111111000001010000100
00000111111100011101100010000000001000001010000100
00000000001100011000100010000000000000001011111100
00000000001100011111100010000000001000001000000000
00000100001100010000000010001111111000001000000000
11111100001100010000000010001000001111111000000000
00000111111100010000000010001000000000000000000000
00000000000100010000000010001000000000000000000000
00111111111100011111111110001111111111111111111100
00100000000000000000000000000000000000000000001100
00100000000000000000000000000000000000000000001100
00100000000000000000000000000000000000000000001100
00100000000001111000111111111111111111111111111100
00100000000001001000100111111111111111111111111100
00100000000001001000100100000000000000000000000100
00100000000001001000100100111110001111111111100100
00100000000001001000100100111110001000000000100100
00100000000001001000100100000000001011110000100100
00100000000001001000111111111110111010010000100100
00100000000001001000100000000100010010010000100100
00100000000001001000100000000100010010010000100100
00100000000001001000100000000100010010010000100100
00100000000001001000100000000100010010011111100100
00100000000001001000100000000100010010000000000100
00111111111111001000100000000100010011111111111100
11111111111111111000111111111100011111111111111111
10000000000000000000000000000000000000000000000001
10000000000000000000000000000000000000000000000001
10000000000000000000000000000000000000000000000001
10001110001111111111111111111111000111111111111111
10001010001001000000000000000000000100000000000000
10001010001001000000000000000000000100000000000000
10001010001001000111111111111111111100000000000000
10001010001001000000000000000000001000000000000000
10001010001001000000000000000000000100000000000000
10001010001001000000000000000000000100000000000000
10001010001001111111111111111111000100000000000000
10001010001111111111111110000001000111111111111111
10001010000000000000010010000001000000000000001001
10001010000000000000000010000001000000000000000001
10001010000000000000010010000001000000000000001001
10001011111111111111111110000001111111111111111111
11111000000000000000000000000000000000000000000000
&
0,100